MODE 2
SIZE 11/70
LIMIT 0/29
COLOR LIMIT 5
STARS 600/2300/4800
POWERUPS 1/1/0/1
14 10 0 0 0 0 0 0 0 10 13
17 7 7 7 7 7 7 7 7 7 17
17 7 7 7 7 7 7 7 7 7 17
17 7 7 7 7 7 7 7 7 7 17
17 0 0 0 0 0 0 0 0 0 17
11 10 0 0 0 0 0 0 0 10 12
17 7 7 7 7 7 7 7 7 7 17
17 7 7 7 7 7 7 7 7 7 17
17 7 7 7 7 7 7 7 7 7 17
17 0 0 0 0 0 0 0 0 0 17
11 10 0 0 0 0 0 0 0 10 12
17 7 7 7 7 7 7 7 7 7 17
17 7 7 7 7 7 7 7 7 7 17
17 7 7 7 7 7 7 7 7 7 17
17 0 0 0 0 0 0 0 0 0 17
13 10 0 0 0 0 0 0 0 10 14
17 7 7 7 7 7 7 7 7 7 17
17 7 7 7 7 7 7 7 7 7 17
17 7 7 7 7 7 7 7 7 7 17
17 0 0 0 0 0 0 0 0 0 17
17 0 0 0 0 0 0 0 0 0 17
17 0 0 0 0 0 0 0 0 0 17
17 0 0 0 0 0 0 0 0 0 17
17 0 0 0 0 0 0 0 0 0 17
17 0 0 0 0 0 0 0 0 0 17
17 0 0 0 0 0 0 0 0 0 17
0 0 0 0 0 0 0 0 0 0 0
0 0 0 0 0 0 0 0 0 0 0
0 0 0 0 0 0 0 0 0 0 0
0 0 0 0 0 0 0 0 0 0 0
0 0 0 0 0 0 0 0 0 0 0
0 0 0 0 0 0 0 0 0 0 0
0 0 0 0 0 0 0 0 0 0 0
0 0 0 0 0 0 0 0 0 0 0
0 0 0 0 0 0 0 0 0 0 0
0 0 0 0 0 0 0 0 0 0 0
0 0 0 0 0 0 0 0 0 0 0
0 0 0 0 0 0 0 0 0 0 0
0 0 0 0 0 0 0 0 0 0 0
0 0 0 0 0 0 0 0 0 0 0
0 0 0 0 0 0 0 0 0 0 0
0 0 0 0 0 0 0 0 0 0 0
0 0 0 0 0 0 0 0 0 0 0
0 0 0 0 0 0 0 0 0 0 0
0 0 0 0 0 0 0 0 0 0 0
0 0 0 0 0 0 0 0 0 0 0
0 0 0 0 0 0 0 0 0 0 0
0 0 0 0 0 0 0 0 0 0 0
0 0 0 0 0 0 0 0 0 0 0
0 0 0 0 0 0 0 0 0 0 0
0 0 0 0 0 0 0 0 0 0 0
0 0 0 0 0 0 0 0 0 0 0
0 0 0 0 0 0 0 0 0 0 0
0 0 0 0 0 0 0 0 0 0 0
0 0 0 0 0 0 0 0 0 0 0
0 0 0 0 0 0 0 0 0 0 0
0 0 0 0 0 0 0 0 0 0 0
0 0 0 0 0 0 0 0 0 0 0
0 0 0 0 0 0 0 0 0 0 0
0 0 0 0 0 0 0 0 0 0 0
0 0 0 0 0 0 0 0 0 0 0
0 0 0 0 0 0 0 0 0 0 0
0 0 0 0 0 0 0 0 0 0 0
0 0 0 0 0 0 0 0 0 0 0
0 0 0 0 0 0 0 0 0 0 0
0 0 0 0 0 0 0 0 0 0 0
0 0 0 0 0 0 0 0 0 0 0
0 0 0 0 0 0 0 0 0 0 0
0 0 0 0 0 0 0 0 0 0 0
0 0 0 0 0 0 0 0 0 0 0