MODE 2
SIZE 11/70
LIMIT 0/25
COLOR LIMIT 5
STARS 700/3100/4500
POWERUPS 1/1/0/1
0 7 7 7 7 0 0 7 13 7 7
0 7 7 7 7 0 7 7 7 7 0
0 0 17 9 7 7 7 7 9 17 0
0 0 17 17 0 0 0 17 17 0 0
0 0 7 12 7 0 0 7 7 7 0
0 0 7 7 0 0 0 7 7 0 0
0 0 0 7 7 0 0 7 7 0 0
0 0 17 9 7 0 7 9 17 0 0
0 0 0 17 17 0 0 17 17 0 0
0 0 0 7 7 0 7 12 0 0 0
0 0 0 7 7 7 7 7 7 0 0
0 0 0 7 7 0 7 7 0 0 0
0 0 0 0 0 7 7 0 0 0 0
0 0 0 0 7 8 17 0 0 0 0
0 0 0 0 0 17 17 0 0 0 0
0 0 0 0 7 11 7 0 0 0 0
0 0 0 0 0 7 7 0 0 0 0
0 0 0 0 17 8 7 0 0 0 0
0 0 0 0 0 17 17 0 0 0 0
0 0 0 0 7 7 7 0 0 0 0
0 0 0 0 0 7 7 0 0 0 0
0 0 0 0 7 8 17 0 0 0 0
0 0 0 0 0 17 17 0 0 0 0
0 0 0 0 7 11 7 0 0 0 0
0 0 0 0 0 7 7 0 0 0 0
0 0 0 0 17 8 7 0 0 0 0
0 0 0 0 0 17 17 0 0 0 0
0 0 0 0 7 7 7 0 0 0 0
0 0 0 0 0 7 7 0 0 0 0
0 0 0 0 7 8 17 0 0 0 0
0 0 0 0 0 17 17 0 0 0 0
0 0 0 0 7 14 7 0 0 0 0
0 0 0 0 0 7 7 0 0 0 0
0 0 0 0 17 8 7 0 0 0 0
0 0 0 0 0 17 17 0 0 0 0
0 0 0 0 7 7 7 0 0 0 0
0 0 0 0 0 7 7 0 0 0 0
0 0 0 0 7 8 17 0 0 0 0
0 0 0 0 0 17 17 0 0 0 0
0 0 0 0 7 14 7 0 0 0 0
0 0 0 0 0 7 7 0 0 0 0
0 0 0 0 17 8 7 0 0 0 0
0 0 0 0 0 17 17 0 0 0 0
0 0 0 0 7 13 7 0 0 0 0
0 0 0 0 0 7 7 0 0 0 0
0 0 0 0 7 8 17 0 0 0 0
0 0 0 0 0 17 17 0 0 0 0
0 0 0 0 0 0 0 0 0 0 0
0 0 0 0 0 0 0 0 0 0 0
0 0 0 0 0 0 0 0 0 0 0
0 0 0 0 0 0 0 0 0 0 0
0 0 0 0 0 0 0 0 0 0 0
0 0 0 0 0 0 0 0 0 0 0
0 0 0 0 0 0 0 0 0 0 0
0 0 0 0 0 0 0 0 0 0 0
0 0 0 0 0 0 0 0 0 0 0
0 0 0 0 0 0 0 0 0 0 0
0 0 0 0 0 0 0 0 0 0 0
0 0 0 0 0 0 0 0 0 0 0
0 0 0 0 0 0 0 0 0 0 0
0 0 0 0 0 0 0 0 0 0 0
0 0 0 0 0 0 0 0 0 0 0
0 0 0 0 0 0 0 0 0 0 0
0 0 0 0 0 0 0 0 0 0 0
0 0 0 0 0 0 0 0 0 0 0
0 0 0 0 0 0 0 0 0 0 0
0 0 0 0 0 0 0 0 0 0 0
0 0 0 0 0 0 0 0 0 0 0
0 0 0 0 0 0 0 0 0 0 0
0 0 0 0 0 0 0 0 0 0 0