MODE 2
SIZE 11/70
LIMIT 0/26
COLOR LIMIT 5
STARS 600/2800/5400
POWERUPS 0/0/1/1
7 7 7 7 7 7 7 4 7 7 13
7 7 11 7 7 7 7 7 7 7 7
0 0 0 0 0 0 0 0 7 7 7
0 0 0 0 0 0 0 7 7 7 0
7 7 7 7 7 7 7 7 7 7 0
7 7 7 7 7 12 7 7 7 0 0
0 7 7 7 0 0 0 0 0 0 0
0 7 7 7 0 0 0 0 0 0 0
0 0 7 7 7 7 7 7 7 7 7
0 0 13 7 7 7 7 7 7 7 7
0 0 0 0 0 0 0 0 7 7 7
0 0 0 0 0 0 0 7 7 7 0
7 7 7 7 7 7 7 7 7 7 0
7 7 7 7 7 7 7 7 11 0 0
0 7 7 7 0 0 0 0 0 0 0
0 7 7 7 0 0 0 0 0 0 0
0 0 7 7 7 7 7 7 7 7 7
0 0 7 7 7 12 7 7 7 7 7
0 0 0 0 0 0 0 0 7 7 7
0 0 0 0 0 0 0 7 7 7 0
7 7 7 7 11 7 7 7 7 7 0
7 7 7 7 7 7 7 7 13 0 0
0 7 7 7 0 0 0 0 0 0 0
0 7 7 7 0 0 0 0 0 0 0
0 0 7 7 7 7 7 7 7 7 7
0 0 7 7 7 12 7 7 7 7 7
0 0 0 0 0 0 0 0 7 7 7
0 0 0 0 0 0 0 7 7 7 0
7 7 7 7 7 7 7 7 7 7 0
7 7 7 7 7 7 11 7 7 0 0
0 7 7 7 0 0 0 0 0 0 0
0 7 7 7 0 0 0 0 0 0 0
0 0 7 7 7 7 7 7 7 7 7
0 0 7 7 7 12 7 7 7 7 7
0 0 0 0 0 0 0 0 7 7 7
0 0 0 0 0 0 0 7 7 7 0
7 7 7 7 7 11 7 7 7 7 0
7 7 7 7 7 7 7 7 7 0 0
0 7 7 7 0 0 0 0 0 0 0
0 7 7 7 0 0 0 0 0 0 0
0 0 7 7 7 7 7 7 7 7 7
0 0 7 7 7 7 7 7 7 7 7
0 0 0 0 0 0 0 0 7 7 7
0 0 0 0 0 0 0 7 7 7 0
7 7 7 7 11 7 7 7 7 7 0
7 7 7 7 7 7 7 7 7 0 0
0 0 0 0 0 0 0 0 0 0 0
0 0 0 0 0 0 0 0 0 0 0
0 0 0 0 0 0 0 0 0 0 0
0 0 0 0 0 0 0 0 0 0 0
0 0 0 0 0 0 0 0 0 0 0
0 0 0 0 0 0 0 0 0 0 0
0 0 0 0 0 0 0 0 0 0 0
0 0 0 0 0 0 0 0 0 0 0
0 0 0 0 0 0 0 0 0 0 0
0 0 0 0 0 0 0 0 0 0 0
0 0 0 0 0 0 0 0 0 0 0
0 0 0 0 0 0 0 0 0 0 0
0 0 0 0 0 0 0 0 0 0 0
0 0 0 0 0 0 0 0 0 0 0
0 0 0 0 0 0 0 0 0 0 0
0 0 0 0 0 0 0 0 0 0 0
0 0 0 0 0 0 0 0 0 0 0
0 0 0 0 0 0 0 0 0 0 0
0 0 0 0 0 0 0 0 0 0 0
0 0 0 0 0 0 0 0 0 0 0
0 0 0 0 0 0 0 0 0 0 0
0 0 0 0 0 0 0 0 0 0 0
0 0 0 0 0 0 0 0 0 0 0
0 0 0 0 0 0 0 0 0 0 0