MODE 2
SIZE 11/70
LIMIT 0/14
COLOR LIMIT 5
STARS 700/2000/3300
POWERUPS 1/0/0/1
7 7 7 15 7 10 7 7 7 7 7
0 7 0 0 7 7 0 0 7 0 0
0 0 7 0 0 7 0 0 0 7 0
0 9 0 0 7 7 0 0 9 0 0
0 1 1 0 0 2 0 0 5 5 0
1 15 1 17 2 2 17 5 11 5 0
0 1 1 0 0 2 0 0 5 5 0
0 7 0 0 7 7 0 0 7 0 0
0 0 7 0 0 7 0 0 7 0 0
0 7 0 0 7 7 0 0 7 0 0
0 0 7 0 0 9 0 0 7 0 0
0 2 2 0 5 5 0 1 1 0 0
0 2 11 2 17 5 17 1 12 1 0
0 2 2 0 5 5 0 1 1 0 0
0 0 7 0 0 7 0 0 7 0 0
0 7 0 0 7 7 0 0 7 0 0
0 0 7 0 0 7 0 0 7 0 0
0 9 0 0 7 7 0 0 9 0 0
0 5 5 0 0 1 0 0 2 2 0
5 12 5 17 1 1 17 2 15 2 0
0 5 5 0 0 1 0 0 2 2 0
0 0 0 0 0 0 0 0 0 0 0
0 0 0 0 0 0 0 0 0 0 0
0 0 0 0 0 0 0 0 0 0 0
0 0 0 0 0 0 0 0 0 0 0
0 0 0 0 0 0 0 0 0 0 0
0 0 0 0 0 0 0 0 0 0 0
0 0 0 0 0 0 0 0 0 0 0
0 0 0 0 0 0 0 0 0 0 0
0 0 0 0 0 0 0 0 0 0 0
0 0 0 0 0 0 0 0 0 0 0
0 0 0 0 0 0 0 0 0 0 0
0 0 0 0 0 0 0 0 0 0 0
0 0 0 0 0 0 0 0 0 0 0
0 0 0 0 0 0 0 0 0 0 0
0 0 0 0 0 0 0 0 0 0 0
0 0 0 0 0 0 0 0 0 0 0
0 0 0 0 0 0 0 0 0 0 0
0 0 0 0 0 0 0 0 0 0 0
0 0 0 0 0 0 0 0 0 0 0
0 0 0 0 0 0 0 0 0 0 0
0 0 0 0 0 0 0 0 0 0 0
0 0 0 0 0 0 0 0 0 0 0
0 0 0 0 0 0 0 0 0 0 0
0 0 0 0 0 0 0 0 0 0 0
0 0 0 0 0 0 0 0 0 0 0
0 0 0 0 0 0 0 0 0 0 0
0 0 0 0 0 0 0 0 0 0 0
0 0 0 0 0 0 0 0 0 0 0
0 0 0 0 0 0 0 0 0 0 0
0 0 0 0 0 0 0 0 0 0 0
0 0 0 0 0 0 0 0 0 0 0
0 0 0 0 0 0 0 0 0 0 0
0 0 0 0 0 0 0 0 0 0 0
0 0 0 0 0 0 0 0 0 0 0
0 0 0 0 0 0 0 0 0 0 0
0 0 0 0 0 0 0 0 0 0 0
0 0 0 0 0 0 0 0 0 0 0
0 0 0 0 0 0 0 0 0 0 0
0 0 0 0 0 0 0 0 0 0 0
0 0 0 0 0 0 0 0 0 0 0
0 0 0 0 0 0 0 0 0 0 0
0 0 0 0 0 0 0 0 0 0 0
0 0 0 0 0 0 0 0 0 0 0
0 0 0 0 0 0 0 0 0 0 0
0 0 0 0 0 0 0 0 0 0 0
0 0 0 0 0 0 0 0 0 0 0
0 0 0 0 0 0 0 0 0 0 0
0 0 0 0 0 0 0 0 0 0 0
0 0 0 0 0 0 0 0 0 0 0