MODE 2
SIZE 11/70
LIMIT 0/40
COLOR LIMIT 5
STARS 900/3100/5300
POWERUPS 1/1/0/1
10 18 13 18 18 7 18 15 18 18 10
18 18 7 18 7 18 18 7 18 7 7
0 0 0 0 0 10 0 0 0 0 0
5 5 5 5 5 1 3 3 3 3 3
11 3 3 3 3 3 1 5 5 5 5
0 0 0 0 17 17 0 0 0 0 0
7 7 7 7 7 7 7 7 7 7 7
7 7 7 7 7 7 7 7 7 7 7
0 0 0 0 0 10 0 0 0 0 0
1 1 1 1 1 5 2 2 2 2 2
2 2 2 2 2 7 1 1 1 1 11
0 0 0 0 17 17 0 0 0 0 0
2 19 19 2 19 3 19 19 1 19 1
2 19 2 19 19 3 19 1 19 19 1
0 0 0 0 0 10 0 0 0 0 0
13 5 5 5 5 2 3 3 3 3 3
3 3 3 3 3 7 2 5 5 5 5
0 0 0 0 17 17 0 0 0 0 0
1 19 19 1 19 19 2 19 19 2 19
1 19 1 1 19 2 2 19 2 19 19
0 0 0 0 0 10 0 0 0 0 0
1 1 1 1 1 3 2 2 2 2 2
12 2 2 2 2 2 3 1 1 1 1
0 0 0 0 17 17 0 0 0 0 0
1 19 19 2 19 2 19 19 3 19 5
1 19 2 19 19 12 19 3 19 19 5
0 0 0 0 0 0 0 0 0 0 0
0 0 0 0 0 0 0 0 0 0 0
0 0 0 0 0 0 0 0 0 0 0
0 0 0 0 0 0 0 0 0 0 0
0 0 0 0 0 0 0 0 0 0 0
0 0 0 0 0 0 0 0 0 0 0
0 0 0 0 0 0 0 0 0 0 0
0 0 0 0 0 0 0 0 0 0 0
0 0 0 0 0 0 0 0 0 0 0
0 0 0 0 0 0 0 0 0 0 0
0 0 0 0 0 0 0 0 0 0 0
0 0 0 0 0 0 0 0 0 0 0
0 0 0 0 0 0 0 0 0 0 0
0 0 0 0 0 0 0 0 0 0 0
0 0 0 0 0 0 0 0 0 0 0
0 0 0 0 0 0 0 0 0 0 0
0 0 0 0 0 0 0 0 0 0 0
0 0 0 0 0 0 0 0 0 0 0
0 0 0 0 0 0 0 0 0 0 0
0 0 0 0 0 0 0 0 0 0 0
0 0 0 0 0 0 0 0 0 0 0
0 0 0 0 0 0 0 0 0 0 0
0 0 0 0 0 0 0 0 0 0 0
0 0 0 0 0 0 0 0 0 0 0
0 0 0 0 0 0 0 0 0 0 0
0 0 0 0 0 0 0 0 0 0 0
0 0 0 0 0 0 0 0 0 0 0
0 0 0 0 0 0 0 0 0 0 0
0 0 0 0 0 0 0 0 0 0 0
0 0 0 0 0 0 0 0 0 0 0
0 0 0 0 0 0 0 0 0 0 0
0 0 0 0 0 0 0 0 0 0 0
0 0 0 0 0 0 0 0 0 0 0
0 0 0 0 0 0 0 0 0 0 0
0 0 0 0 0 0 0 0 0 0 0
0 0 0 0 0 0 0 0 0 0 0
0 0 0 0 0 0 0 0 0 0 0
0 0 0 0 0 0 0 0 0 0 0
0 0 0 0 0 0 0 0 0 0 0
0 0 0 0 0 0 0 0 0 0 0
0 0 0 0 0 0 0 0 0 0 0
0 0 0 0 0 0 0 0 0 0 0
0 0 0 0 0 0 0 0 0 0 0
0 0 0 0 0 0 0 0 0 0 0