MODE 2
SIZE 11/70
LIMIT 0/32
COLOR LIMIT 5
STARS 1200/3100/6700
POWERUPS 1/1/0/1
2 2 2 0 2 10 2 0 2 2 2
1 1 1 2 18 18 2 1 1 1 0
18 18 18 0 2 11 2 0 18 18 18
17 17 17 0 2 2 0 0 17 17 17
2 2 2 0 4 18 4 0 2 2 2
1 1 1 4 18 18 4 1 1 1 0
18 18 18 0 4 12 4 0 18 18 18
17 17 17 0 4 4 0 0 17 17 17
2 2 2 0 5 10 5 0 2 2 2
1 1 1 5 18 18 5 1 1 1 0
18 18 18 0 5 13 5 0 18 18 18
17 17 17 0 5 5 0 0 17 17 17
2 2 2 0 3 18 3 0 2 2 2
1 1 1 3 18 18 3 1 1 1 0
18 18 18 0 3 15 3 0 18 18 18
17 17 17 0 3 3 0 0 17 17 17
2 2 2 0 2 10 2 0 2 2 2
1 1 1 2 18 18 2 1 1 1 0
18 18 18 0 2 11 2 0 18 18 18
17 17 17 0 2 2 0 0 17 17 17
2 2 2 0 4 18 4 0 2 2 2
1 1 1 4 18 18 4 1 1 1 0
18 18 18 0 4 12 4 0 18 18 18
17 17 17 0 4 4 0 0 17 17 17
0 0 0 0 0 0 0 0 0 0 0
0 0 0 0 0 0 0 0 0 0 0
0 0 0 0 0 0 0 0 0 0 0
0 0 0 0 0 0 0 0 0 0 0
0 0 0 0 0 0 0 0 0 0 0
0 0 0 0 0 0 0 0 0 0 0
0 0 0 0 0 0 0 0 0 0 0
0 0 0 0 0 0 0 0 0 0 0
0 0 0 0 0 0 0 0 0 0 0
0 0 0 0 0 0 0 0 0 0 0
0 0 0 0 0 0 0 0 0 0 0
0 0 0 0 0 0 0 0 0 0 0
0 0 0 0 0 0 0 0 0 0 0
0 0 0 0 0 0 0 0 0 0 0
0 0 0 0 0 0 0 0 0 0 0
0 0 0 0 0 0 0 0 0 0 0
0 0 0 0 0 0 0 0 0 0 0
0 0 0 0 0 0 0 0 0 0 0
0 0 0 0 0 0 0 0 0 0 0
0 0 0 0 0 0 0 0 0 0 0
0 0 0 0 0 0 0 0 0 0 0
0 0 0 0 0 0 0 0 0 0 0
0 0 0 0 0 0 0 0 0 0 0
0 0 0 0 0 0 0 0 0 0 0
0 0 0 0 0 0 0 0 0 0 0
0 0 0 0 0 0 0 0 0 0 0
0 0 0 0 0 0 0 0 0 0 0
0 0 0 0 0 0 0 0 0 0 0
0 0 0 0 0 0 0 0 0 0 0
0 0 0 0 0 0 0 0 0 0 0
0 0 0 0 0 0 0 0 0 0 0
0 0 0 0 0 0 0 0 0 0 0
0 0 0 0 0 0 0 0 0 0 0
0 0 0 0 0 0 0 0 0 0 0
0 0 0 0 0 0 0 0 0 0 0
0 0 0 0 0 0 0 0 0 0 0
0 0 0 0 0 0 0 0 0 0 0
0 0 0 0 0 0 0 0 0 0 0
0 0 0 0 0 0 0 0 0 0 0
0 0 0 0 0 0 0 0 0 0 0
0 0 0 0 0 0 0 0 0 0 0
0 0 0 0 0 0 0 0 0 0 0
0 0 0 0 0 0 0 0 0 0 0
0 0 0 0 0 0 0 0 0 0 0
0 0 0 0 0 0 0 0 0 0 0
0 0 0 0 0 0 0 0 0 0 0