MODE 2
SIZE 11/70
LIMIT 0/26
COLOR LIMIT 5
STARS 500/2100/3600
POWERUPS 1/1/0/1
0 7 7 0 0 7 7 0 0 7 7
7 15 7 0 7 10 7 0 7 12 7
0 7 7 0 0 17 17 0 0 7 7
0 2 2 18 0 0 0 18 17 17 0
0 0 0 18 18 0 0 18 18 0 0
0 0 0 18 0 0 0 18 0 0 0
0 7 7 17 17 7 7 2 2 7 7
7 11 7 0 7 9 7 0 7 8 7
0 7 7 0 0 7 7 0 0 7 7
0 2 2 7 0 0 0 7 17 17 0
0 0 0 7 7 0 0 7 7 0 0
0 0 0 7 0 0 0 7 0 0 0
0 7 7 17 17 7 7 2 2 7 7
7 7 7 0 7 12 7 0 7 13 7
0 7 7 0 0 7 7 0 0 7 7
0 2 2 18 0 0 0 18 17 17 0
0 0 0 18 18 0 0 18 18 0 0
0 0 0 18 0 0 0 18 0 0 0
0 7 7 17 17 7 7 2 2 7 7
7 13 7 0 7 11 7 0 7 8 7
0 7 7 0 0 7 7 0 0 7 7
0 0 0 0 0 0 0 0 0 0 0
0 0 0 0 0 0 0 0 0 0 0
0 0 0 0 0 0 0 0 0 0 0
0 0 0 0 0 0 0 0 0 0 0
0 0 0 0 0 0 0 0 0 0 0
0 0 0 0 0 0 0 0 0 0 0
0 0 0 0 0 0 0 0 0 0 0
0 0 0 0 0 0 0 0 0 0 0
0 0 0 0 0 0 0 0 0 0 0
0 0 0 0 0 0 0 0 0 0 0
0 0 0 0 0 0 0 0 0 0 0
0 0 0 0 0 0 0 0 0 0 0
0 0 0 0 0 0 0 0 0 0 0
0 0 0 0 0 0 0 0 0 0 0
0 0 0 0 0 0 0 0 0 0 0
0 0 0 0 0 0 0 0 0 0 0
0 0 0 0 0 0 0 0 0 0 0
0 0 0 0 0 0 0 0 0 0 0
0 0 0 0 0 0 0 0 0 0 0
0 0 0 0 0 0 0 0 0 0 0
0 0 0 0 0 0 0 0 0 0 0
0 0 0 0 0 0 0 0 0 0 0
0 0 0 0 0 0 0 0 0 0 0
0 0 0 0 0 0 0 0 0 0 0
0 0 0 0 0 0 0 0 0 0 0
0 0 0 0 0 0 0 0 0 0 0
0 0 0 0 0 0 0 0 0 0 0
0 0 0 0 0 0 0 0 0 0 0
0 0 0 0 0 0 0 0 0 0 0
0 0 0 0 0 0 0 0 0 0 0
0 0 0 0 0 0 0 0 0 0 0
0 0 0 0 0 0 0 0 0 0 0
0 0 0 0 0 0 0 0 0 0 0
0 0 0 0 0 0 0 0 0 0 0
0 0 0 0 0 0 0 0 0 0 0
0 0 0 0 0 0 0 0 0 0 0
0 0 0 0 0 0 0 0 0 0 0
0 0 0 0 0 0 0 0 0 0 0
0 0 0 0 0 0 0 0 0 0 0
0 0 0 0 0 0 0 0 0 0 0
0 0 0 0 0 0 0 0 0 0 0
0 0 0 0 0 0 0 0 0 0 0
0 0 0 0 0 0 0 0 0 0 0
0 0 0 0 0 0 0 0 0 0 0
0 0 0 0 0 0 0 0 0 0 0
0 0 0 0 0 0 0 0 0 0 0
0 0 0 0 0 0 0 0 0 0 0
0 0 0 0 0 0 0 0 0 0 0
0 0 0 0 0 0 0 0 0 0 0