MODE 2
SIZE 11/70
LIMIT 0/25
COLOR LIMIT 5
STARS 800/2300/5500
POWERUPS 1/0/0/1
7 7 7 7 7 7 7 7 7 7 7
7 7 7 7 7 14 7 7 7 7 7
7 7 7 0 0 0 0 0 0 0 0
7 7 7 0 0 0 0 0 0 0 0
0 7 7 9 0 0 0 0 0 0 0
0 7 7 7 7 1 7 7 7 7 15
0 0 7 7 7 7 1 7 7 7 7
0 0 0 0 0 0 0 0 7 7 7
0 0 0 0 0 0 0 0 7 7 7
0 0 0 0 0 0 0 9 7 7 0
7 7 7 7 2 7 7 7 7 7 0
7 11 7 7 2 7 7 7 7 0 0
7 7 7 0 0 0 0 0 0 0 0
7 7 7 0 0 0 0 0 0 0 0
0 7 7 9 0 0 0 0 0 0 0
0 7 7 7 7 1 7 7 7 7 7
0 0 7 15 7 7 1 7 7 7 7
0 0 0 0 0 0 0 0 7 7 7
0 0 0 0 0 0 0 0 7 7 7
0 0 0 0 0 0 0 9 7 7 0
7 7 7 7 2 7 7 7 7 7 0
7 11 7 7 2 7 7 7 7 0 0
7 7 7 0 0 0 0 0 0 0 0
7 7 7 0 0 0 0 0 0 0 0
0 7 7 9 0 0 0 0 0 0 0
0 7 7 7 7 1 7 7 7 15 7
0 0 7 7 7 7 1 7 7 7 7
0 0 0 0 0 0 0 0 7 7 7
0 0 0 0 0 0 0 0 7 7 7
0 0 0 0 0 0 0 9 7 7 0
7 7 7 7 2 7 7 7 7 7 0
12 7 7 7 2 7 7 7 7 0 0
7 7 7 0 0 0 0 0 0 0 0
7 7 7 0 0 0 0 0 0 0 0
0 7 7 9 0 0 0 0 0 0 0
0 7 7 7 7 1 7 7 7 7 11
0 0 7 7 7 7 1 7 7 7 7
0 0 0 0 0 0 0 0 7 7 7
0 0 0 0 0 0 0 0 7 7 7
0 0 0 0 0 0 0 9 7 7 0
12 7 7 2 7 7 7 7 7 7 0
7 7 7 2 7 7 7 7 7 0 0
0 0 0 0 0 0 0 0 0 0 0
0 0 0 0 0 0 0 0 0 0 0
0 0 0 0 0 0 0 0 0 0 0
0 0 0 0 0 0 0 0 0 0 0
0 0 0 0 0 0 0 0 0 0 0
0 0 0 0 0 0 0 0 0 0 0
0 0 0 0 0 0 0 0 0 0 0
0 0 0 0 0 0 0 0 0 0 0
0 0 0 0 0 0 0 0 0 0 0
0 0 0 0 0 0 0 0 0 0 0
0 0 0 0 0 0 0 0 0 0 0
0 0 0 0 0 0 0 0 0 0 0
0 0 0 0 0 0 0 0 0 0 0
0 0 0 0 0 0 0 0 0 0 0
0 0 0 0 0 0 0 0 0 0 0
0 0 0 0 0 0 0 0 0 0 0
0 0 0 0 0 0 0 0 0 0 0
0 0 0 0 0 0 0 0 0 0 0
0 0 0 0 0 0 0 0 0 0 0
0 0 0 0 0 0 0 0 0 0 0
0 0 0 0 0 0 0 0 0 0 0
0 0 0 0 0 0 0 0 0 0 0
0 0 0 0 0 0 0 0 0 0 0
0 0 0 0 0 0 0 0 0 0 0
0 0 0 0 0 0 0 0 0 0 0
0 0 0 0 0 0 0 0 0 0 0
0 0 0 0 0 0 0 0 0 0 0
0 0 0 0 0 0 0 0 0 0 0