MODE 2
SIZE 11/70
LIMIT 0/29
COLOR LIMIT 5
STARS 900/2400/4500
POWERUPS 1/0/0/1
0 7 7 0 0 0 0 0 0 0 0
7 15 7 7 7 7 7 7 7 7 7
0 7 7 0 0 0 7 0 0 17 0
0 17 0 0 0 7 0 0 7 7 0
18 18 18 18 18 9 7 7 7 12 7
0 17 0 0 18 0 0 0 7 7 0
0 7 7 0 18 0 0 0 0 17 0
7 10 7 7 7 7 18 18 18 18 18
0 7 7 0 0 0 18 0 0 17 0
0 17 0 0 0 18 0 0 7 7 0
18 18 18 18 18 8 18 18 7 7 7
0 17 0 0 7 0 0 0 7 7 0
0 7 7 0 7 0 0 0 0 17 0
7 11 7 7 7 7 18 18 18 18 18
0 7 7 0 0 0 18 0 0 17 0
0 17 0 0 0 18 0 0 7 7 0
18 18 18 18 18 9 7 7 7 15 7
0 17 0 0 18 0 0 0 7 7 0
0 7 7 0 18 0 0 0 0 17 0
7 12 7 18 18 18 18 18 18 18 18
0 7 7 0 0 0 0 0 0 0 0
0 0 0 0 0 0 0 0 0 0 0
0 0 0 0 0 0 0 0 0 0 0
0 0 0 0 0 0 0 0 0 0 0
0 0 0 0 0 0 0 0 0 0 0
0 0 0 0 0 0 0 0 0 0 0
0 0 0 0 0 0 0 0 0 0 0
0 0 0 0 0 0 0 0 0 0 0
0 0 0 0 0 0 0 0 0 0 0
0 0 0 0 0 0 0 0 0 0 0
0 0 0 0 0 0 0 0 0 0 0
0 0 0 0 0 0 0 0 0 0 0
0 0 0 0 0 0 0 0 0 0 0
0 0 0 0 0 0 0 0 0 0 0
0 0 0 0 0 0 0 0 0 0 0
0 0 0 0 0 0 0 0 0 0 0
0 0 0 0 0 0 0 0 0 0 0
0 0 0 0 0 0 0 0 0 0 0
0 0 0 0 0 0 0 0 0 0 0
0 0 0 0 0 0 0 0 0 0 0
0 0 0 0 0 0 0 0 0 0 0
0 0 0 0 0 0 0 0 0 0 0
0 0 0 0 0 0 0 0 0 0 0
0 0 0 0 0 0 0 0 0 0 0
0 0 0 0 0 0 0 0 0 0 0
0 0 0 0 0 0 0 0 0 0 0
0 0 0 0 0 0 0 0 0 0 0
0 0 0 0 0 0 0 0 0 0 0
0 0 0 0 0 0 0 0 0 0 0
0 0 0 0 0 0 0 0 0 0 0
0 0 0 0 0 0 0 0 0 0 0
0 0 0 0 0 0 0 0 0 0 0
0 0 0 0 0 0 0 0 0 0 0
0 0 0 0 0 0 0 0 0 0 0
0 0 0 0 0 0 0 0 0 0 0
0 0 0 0 0 0 0 0 0 0 0
0 0 0 0 0 0 0 0 0 0 0
0 0 0 0 0 0 0 0 0 0 0
0 0 0 0 0 0 0 0 0 0 0
0 0 0 0 0 0 0 0 0 0 0
0 0 0 0 0 0 0 0 0 0 0
0 0 0 0 0 0 0 0 0 0 0
0 0 0 0 0 0 0 0 0 0 0
0 0 0 0 0 0 0 0 0 0 0
0 0 0 0 0 0 0 0 0 0 0
0 0 0 0 0 0 0 0 0 0 0
0 0 0 0 0 0 0 0 0 0 0
0 0 0 0 0 0 0 0 0 0 0
0 0 0 0 0 0 0 0 0 0 0
0 0 0 0 0 0 0 0 0 0 0