MODE 2
SIZE 11/70
LIMIT 0/25
COLOR LIMIT 5
STARS 1000/2500/5200
POWERUPS 1/1/0/0
7 7 7 7 7 7 7 7 7 7 13
7 7 11 7 7 7 7 7 7 7 7
0 0 0 0 0 0 0 0 7 7 7
0 0 0 0 0 0 0 7 7 7 0
7 7 7 7 7 7 7 7 7 7 0
7 7 7 7 7 12 7 7 7 0 0
0 7 7 7 0 0 0 0 0 0 0
0 7 7 7 0 0 0 0 0 0 0
0 0 7 7 7 7 7 7 7 7 7
0 0 13 7 7 7 7 7 7 7 7
0 0 0 0 0 0 0 0 7 7 7
0 0 0 0 0 0 0 7 7 7 0
7 7 7 7 7 7 7 7 7 7 0
7 7 7 7 7 7 7 7 15 0 0
0 7 7 7 0 0 0 0 0 0 0
0 7 7 7 0 0 0 0 0 0 0
0 0 7 7 7 7 7 7 7 7 7
0 0 7 7 7 12 7 7 7 7 7
0 0 0 0 0 0 0 0 7 7 7
0 0 0 0 0 0 0 7 7 7 0
7 7 7 7 15 7 7 7 7 7 0
7 7 7 7 7 7 7 7 13 0 0
0 7 7 7 0 0 0 0 0 0 0
0 7 7 7 0 0 0 0 0 0 0
0 0 7 7 7 7 7 7 7 7 7
0 0 7 7 7 12 7 7 7 7 7
0 0 0 0 0 0 0 0 7 7 7
0 0 0 0 0 0 0 7 7 7 0
7 7 7 7 7 7 7 7 7 7 0
7 7 7 7 7 7 11 7 7 0 0
0 7 7 7 0 0 0 0 0 0 0
0 7 7 7 0 0 0 0 0 0 0
0 0 7 7 7 7 7 7 7 7 7
0 0 13 7 7 12 7 7 7 7 7
0 0 0 0 0 0 0 0 7 7 7
0 0 0 0 0 0 0 7 7 7 0
7 7 7 7 7 15 7 7 7 7 0
7 7 7 7 7 7 7 7 7 0 0
0 7 7 7 0 0 0 0 0 0 0
0 7 7 7 0 0 0 0 0 0 0
0 0 7 7 7 7 7 7 7 7 7
0 0 7 7 7 12 7 7 7 7 7
0 0 0 0 0 0 0 0 7 8 7
0 0 0 0 0 0 0 7 7 7 0
7 7 7 7 11 7 7 7 7 7 0
7 7 7 7 7 7 7 7 7 0 0
0 0 0 0 0 0 0 0 0 0 0
0 0 0 0 0 0 0 0 0 0 0
0 0 0 0 0 0 0 0 0 0 0
0 0 0 0 0 0 0 0 0 0 0
0 0 0 0 0 0 0 0 0 0 0
0 0 0 0 0 0 0 0 0 0 0
0 0 0 0 0 0 0 0 0 0 0
0 0 0 0 0 0 0 0 0 0 0
0 0 0 0 0 0 0 0 0 0 0
0 0 0 0 0 0 0 0 0 0 0
0 0 0 0 0 0 0 0 0 0 0
0 0 0 0 0 0 0 0 0 0 0
0 0 0 0 0 0 0 0 0 0 0
0 0 0 0 0 0 0 0 0 0 0
0 0 0 0 0 0 0 0 0 0 0
0 0 0 0 0 0 0 0 0 0 0
0 0 0 0 0 0 0 0 0 0 0
0 0 0 0 0 0 0 0 0 0 0
0 0 0 0 0 0 0 0 0 0 0
0 0 0 0 0 0 0 0 0 0 0
0 0 0 0 0 0 0 0 0 0 0
0 0 0 0 0 0 0 0 0 0 0
0 0 0 0 0 0 0 0 0 0 0
0 0 0 0 0 0 0 0 0 0 0