MODE 2
SIZE 11/70
LIMIT 0/28
COLOR LIMIT 5
STARS 800/2500/4000
POWERUPS 1/1/0/1
0 1 1 0 0 0 0 0 0 2 2
1 11 1 0 0 0 0 0 2 2 2
0 1 1 0 0 0 0 0 0 2 2
2 2 18 18 18 18 18 18 3 3 0
2 12 2 0 0 0 0 0 3 3 3
2 2 17 0 0 0 0 17 3 3 0
17 17 17 0 0 0 0 0 17 17 17
3 3 18 18 18 18 18 18 1 1 0
3 3 3 0 0 0 0 0 1 11 1
3 3 17 0 0 0 0 17 1 1 0
17 17 17 0 0 0 0 0 17 17 17
5 5 18 18 18 18 18 18 2 2 0
5 5 5 0 0 0 0 0 2 12 2
5 5 17 0 0 0 0 17 2 2 0
17 17 17 0 0 0 0 0 17 17 17
1 1 18 18 18 18 18 18 5 5 0
1 11 1 0 0 0 0 0 5 5 5
1 1 17 0 0 0 0 17 5 5 0
17 17 17 0 0 0 0 0 17 17 17
0 0 0 0 0 0 0 0 0 0 0
0 0 0 0 0 0 0 0 0 0 0
0 0 0 0 0 0 0 0 0 0 0
0 0 0 0 0 0 0 0 0 0 0
0 0 0 0 0 0 0 0 0 0 0
0 0 0 0 0 0 0 0 0 0 0
0 0 0 0 0 0 0 0 0 0 0
0 0 0 0 0 0 0 0 0 0 0
0 0 0 0 0 0 0 0 0 0 0
0 0 0 0 0 0 0 0 0 0 0
0 0 0 0 0 0 0 0 0 0 0
0 0 0 0 0 0 0 0 0 0 0
0 0 0 0 0 0 0 0 0 0 0
0 0 0 0 0 0 0 0 0 0 0
0 0 0 0 0 0 0 0 0 0 0
0 0 0 0 0 0 0 0 0 0 0
0 0 0 0 0 0 0 0 0 0 0
0 0 0 0 0 0 0 0 0 0 0
0 0 0 0 0 0 0 0 0 0 0
0 0 0 0 0 0 0 0 0 0 0
0 0 0 0 0 0 0 0 0 0 0
0 0 0 0 0 0 0 0 0 0 0
0 0 0 0 0 0 0 0 0 0 0
0 0 0 0 0 0 0 0 0 0 0
0 0 0 0 0 0 0 0 0 0 0
0 0 0 0 0 0 0 0 0 0 0
0 0 0 0 0 0 0 0 0 0 0
0 0 0 0 0 0 0 0 0 0 0
0 0 0 0 0 0 0 0 0 0 0
0 0 0 0 0 0 0 0 0 0 0
0 0 0 0 0 0 0 0 0 0 0
0 0 0 0 0 0 0 0 0 0 0
0 0 0 0 0 0 0 0 0 0 0
0 0 0 0 0 0 0 0 0 0 0
0 0 0 0 0 0 0 0 0 0 0
0 0 0 0 0 0 0 0 0 0 0
0 0 0 0 0 0 0 0 0 0 0
0 0 0 0 0 0 0 0 0 0 0
0 0 0 0 0 0 0 0 0 0 0
0 0 0 0 0 0 0 0 0 0 0
0 0 0 0 0 0 0 0 0 0 0
0 0 0 0 0 0 0 0 0 0 0
0 0 0 0 0 0 0 0 0 0 0
0 0 0 0 0 0 0 0 0 0 0
0 0 0 0 0 0 0 0 0 0 0
0 0 0 0 0 0 0 0 0 0 0
0 0 0 0 0 0 0 0 0 0 0
0 0 0 0 0 0 0 0 0 0 0
0 0 0 0 0 0 0 0 0 0 0
0 0 0 0 0 0 0 0 0 0 0
0 0 0 0 0 0 0 0 0 0 0