MODE 2
SIZE 11/70
LIMIT 0/25
COLOR LIMIT 5
STARS 900/2600/4500
POWERUPS 0/0/1/0
7 7 7 7 7 7 7 7 7 7 7
7 7 0 0 7 7 0 0 0 7 7
7 7 0 0 0 7 7 0 0 7 11
7 14 0 0 7 9 0 0 0 7 7
7 7 7 7 7 7 7 7 7 7 7
12 7 0 0 7 7 0 0 0 7 7
7 7 0 0 0 7 7 0 0 7 7
7 7 7 7 7 7 7 7 7 7 7
7 7 0 0 7 11 0 0 0 12 7
7 7 0 0 7 7 0 0 0 7 7
7 7 0 0 0 7 7 0 0 14 7
7 7 7 7 7 9 7 7 7 7 7
7 7 0 0 0 7 7 0 0 7 7
7 7 0 0 7 7 0 0 0 7 7
7 11 0 0 7 12 0 0 0 7 7
7 7 0 0 7 7 0 0 7 7 0
0 17 17 17 7 7 7 17 17 17 0
0 7 7 0 7 7 0 7 7 0 0
0 0 7 7 0 7 0 7 7 0 0
0 0 7 7 7 12 7 7 0 0 0
0 0 0 7 7 0 7 7 0 0 0
0 0 0 7 7 7 7 0 0 0 0
0 0 0 0 7 7 7 0 0 0 0
0 0 0 0 7 7 0 0 0 0 0
0 0 0 0 0 9 0 0 0 0 0
0 0 0 0 0 0 0 0 0 0 0
0 0 0 0 0 0 0 0 0 0 0
0 0 0 0 0 0 0 0 0 0 0
0 0 0 0 0 0 0 0 0 0 0
0 0 0 0 0 0 0 0 0 0 0
0 0 0 0 0 0 0 0 0 0 0
0 0 0 0 0 0 0 0 0 0 0
0 0 0 0 0 0 0 0 0 0 0
0 0 0 0 0 0 0 0 0 0 0
0 0 0 0 0 0 0 0 0 0 0
0 0 0 0 0 0 0 0 0 0 0
0 0 0 0 0 0 0 0 0 0 0
0 0 0 0 0 0 0 0 0 0 0
0 0 0 0 0 0 0 0 0 0 0
0 0 0 0 0 0 0 0 0 0 0
0 0 0 0 0 0 0 0 0 0 0
0 0 0 0 0 0 0 0 0 0 0
0 0 0 0 0 0 0 0 0 0 0
0 0 0 0 0 0 0 0 0 0 0
0 0 0 0 0 0 0 0 0 0 0
0 0 0 0 0 0 0 0 0 0 0
0 0 0 0 0 0 0 0 0 0 0
0 0 0 0 0 0 0 0 0 0 0
0 0 0 0 0 0 0 0 0 0 0
0 0 0 0 0 0 0 0 0 0 0
0 0 0 0 0 0 0 0 0 0 0
0 0 0 0 0 0 0 0 0 0 0
0 0 0 0 0 0 0 0 0 0 0
0 0 0 0 0 0 0 0 0 0 0
0 0 0 0 0 0 0 0 0 0 0
0 0 0 0 0 0 0 0 0 0 0
0 0 0 0 0 0 0 0 0 0 0
0 0 0 0 0 0 0 0 0 0 0
0 0 0 0 0 0 0 0 0 0 0
0 0 0 0 0 0 0 0 0 0 0
0 0 0 0 0 0 0 0 0 0 0
0 0 0 0 0 0 0 0 0 0 0
0 0 0 0 0 0 0 0 0 0 0
0 0 0 0 0 0 0 0 0 0 0
0 0 0 0 0 0 0 0 0 0 0
0 0 0 0 0 0 0 0 0 0 0
0 0 0 0 0 0 0 0 0 0 0
0 0 0 0 0 0 0 0 0 0 0
0 0 0 0 0 0 0 0 0 0 0
0 0 0 0 0 0 0 0 0 0 0