MODE 2
SIZE 11/70
LIMIT 0/21
COLOR LIMIT 4
STARS 900/4100/5850
POWERUPS 1/0/0/1
7 7 7 7 7 7 7 7 7 7 7
7 7 7 7 14 7 7 7 7 7 0
0 7 7 0 0 0 0 0 7 7 0
0 7 7 0 0 0 0 7 7 0 0
0 0 7 11 0 0 0 7 7 0 0
0 0 7 7 0 0 7 7 0 0 0
0 0 0 7 7 0 7 7 0 0 0
0 0 0 7 7 7 11 0 0 0 0
0 0 0 0 7 8 7 0 0 0 0
0 0 0 0 7 7 0 0 0 0 0
0 0 0 0 7 14 7 0 0 0 0
0 0 0 7 7 7 7 0 0 0 0
0 0 0 7 7 0 7 7 0 0 0
0 0 7 7 0 0 7 7 0 0 0
0 0 12 7 0 0 0 7 12 0 0
0 7 7 0 0 0 0 7 7 0 0
0 7 7 0 0 0 0 0 7 7 0
7 7 7 7 7 7 7 7 7 7 0
13 7 8 7 7 14 7 7 8 7 13
7 7 7 7 7 7 7 7 7 7 0
0 7 7 0 0 0 0 0 7 7 0
0 7 7 0 0 0 0 7 7 0 0
0 0 7 7 0 0 0 7 7 0 0
0 0 7 7 0 0 7 7 0 0 0
0 0 0 7 7 0 7 7 0 0 0
0 0 0 7 7 7 7 0 0 0 0
0 0 0 0 7 8 7 0 0 0 0
7 7 7 7 7 7 7 7 7 7 0
7 7 7 7 7 7 7 7 7 7 7
0 0 0 0 0 0 0 0 0 0 0
0 0 0 0 0 0 0 0 0 0 0
0 0 0 0 0 0 0 0 0 0 0
0 0 0 0 0 0 0 0 0 0 0
0 0 0 0 0 0 0 0 0 0 0
0 0 0 0 0 0 0 0 0 0 0
0 0 0 0 0 0 0 0 0 0 0
0 0 0 0 0 0 0 0 0 0 0
0 0 0 0 0 0 0 0 0 0 0
0 0 0 0 0 0 0 0 0 0 0
0 0 0 0 0 0 0 0 0 0 0
0 0 0 0 0 0 0 0 0 0 0
0 0 0 0 0 0 0 0 0 0 0
0 0 0 0 0 0 0 0 0 0 0
0 0 0 0 0 0 0 0 0 0 0
0 0 0 0 0 0 0 0 0 0 0
0 0 0 0 0 0 0 0 0 0 0
0 0 0 0 0 0 0 0 0 0 0
0 0 0 0 0 0 0 0 0 0 0
0 0 0 0 0 0 0 0 0 0 0
0 0 0 0 0 0 0 0 0 0 0
0 0 0 0 0 0 0 0 0 0 0
0 0 0 0 0 0 0 0 0 0 0
0 0 0 0 0 0 0 0 0 0 0
0 0 0 0 0 0 0 0 0 0 0
0 0 0 0 0 0 0 0 0 0 0
0 0 0 0 0 0 0 0 0 0 0
0 0 0 0 0 0 0 0 0 0 0
0 0 0 0 0 0 0 0 0 0 0
0 0 0 0 0 0 0 0 0 0 0
0 0 0 0 0 0 0 0 0 0 0
0 0 0 0 0 0 0 0 0 0 0
0 0 0 0 0 0 0 0 0 0 0
0 0 0 0 0 0 0 0 0 0 0
0 0 0 0 0 0 0 0 0 0 0
0 0 0 0 0 0 0 0 0 0 0
0 0 0 0 0 0 0 0 0 0 0
0 0 0 0 0 0 0 0 0 0 0
0 0 0 0 0 0 0 0 0 0 0
0 0 0 0 0 0 0 0 0 0 0
0 0 0 0 0 0 0 0 0 0 0