MODE 2
SIZE 11/70
LIMIT 0/17
COLOR LIMIT 5
STARS 500/2300/4700
POWERUPS 1/1/0/1
0 7 7 0 0 7 7 0 0 7 7
7 15 7 0 7 10 7 0 7 12 7
0 7 7 0 0 17 17 0 0 7 7
0 17 17 7 0 0 0 7 17 17 0
0 0 0 7 7 0 0 7 7 0 0
0 0 0 7 0 0 0 7 0 0 0
0 7 7 17 17 7 7 17 17 7 7
7 11 7 0 7 10 7 0 7 8 7
0 7 7 0 0 7 7 0 0 7 7
0 17 17 7 0 0 0 7 17 17 0
0 0 0 7 7 0 0 7 7 0 0
0 0 0 7 0 0 0 7 0 0 0
0 7 7 17 17 7 7 17 17 7 7
7 7 7 0 7 12 7 0 7 13 7
0 7 7 0 0 7 7 0 0 7 7
0 17 17 7 0 0 0 7 17 17 0
0 0 0 7 7 0 0 7 7 0 0
0 0 0 7 0 0 0 7 0 0 0
0 7 7 17 17 7 7 17 17 7 7
7 13 7 0 7 11 7 0 7 8 7
0 7 7 0 0 7 7 0 0 7 7
0 17 17 0 0 0 0 0 17 17 0
0 0 0 0 0 0 0 0 0 0 0
0 0 0 0 0 0 0 0 0 0 0
0 0 0 0 0 0 0 0 0 0 0
0 0 0 0 0 0 0 0 0 0 0
0 0 0 0 0 0 0 0 0 0 0
0 0 0 0 0 0 0 0 0 0 0
0 0 0 0 0 0 0 0 0 0 0
0 0 0 0 0 0 0 0 0 0 0
0 0 0 0 0 0 0 0 0 0 0
0 0 0 0 0 0 0 0 0 0 0
0 0 0 0 0 0 0 0 0 0 0
0 0 0 0 0 0 0 0 0 0 0
0 0 0 0 0 0 0 0 0 0 0
0 0 0 0 0 0 0 0 0 0 0
0 0 0 0 0 0 0 0 0 0 0
0 0 0 0 0 0 0 0 0 0 0
0 0 0 0 0 0 0 0 0 0 0
0 0 0 0 0 0 0 0 0 0 0
0 0 0 0 0 0 0 0 0 0 0
0 0 0 0 0 0 0 0 0 0 0
0 0 0 0 0 0 0 0 0 0 0
0 0 0 0 0 0 0 0 0 0 0
0 0 0 0 0 0 0 0 0 0 0
0 0 0 0 0 0 0 0 0 0 0
0 0 0 0 0 0 0 0 0 0 0
0 0 0 0 0 0 0 0 0 0 0
0 0 0 0 0 0 0 0 0 0 0
0 0 0 0 0 0 0 0 0 0 0
0 0 0 0 0 0 0 0 0 0 0
0 0 0 0 0 0 0 0 0 0 0
0 0 0 0 0 0 0 0 0 0 0
0 0 0 0 0 0 0 0 0 0 0
0 0 0 0 0 0 0 0 0 0 0
0 0 0 0 0 0 0 0 0 0 0
0 0 0 0 0 0 0 0 0 0 0
0 0 0 0 0 0 0 0 0 0 0
0 0 0 0 0 0 0 0 0 0 0
0 0 0 0 0 0 0 0 0 0 0
0 0 0 0 0 0 0 0 0 0 0
0 0 0 0 0 0 0 0 0 0 0
0 0 0 0 0 0 0 0 0 0 0
0 0 0 0 0 0 0 0 0 0 0
0 0 0 0 0 0 0 0 0 0 0
0 0 0 0 0 0 0 0 0 0 0
0 0 0 0 0 0 0 0 0 0 0
0 0 0 0 0 0 0 0 0 0 0
0 0 0 0 0 0 0 0 0 0 0
0 0 0 0 0 0 0 0 0 0 0