MODE 2
SIZE 11/70
LIMIT 0/25
COLOR LIMIT 5
STARS 1000/3000/6800
POWERUPS 1/1/0/1
0 0 7 7 0 0 0 0 0 0 0
7 7 14 7 7 8 0 0 0 0 0
0 17 7 7 17 7 7 0 7 7 0
0 17 17 17 0 0 18 10 7 7 7
0 0 7 7 0 0 18 17 7 14 17
7 7 7 7 7 8 0 17 17 17 0
0 17 7 7 17 7 7 0 7 12 0
0 17 17 17 0 0 18 7 7 7 7
0 0 7 7 0 0 18 17 7 7 17
7 7 7 10 7 8 0 17 17 17 0
0 17 7 7 17 7 7 0 7 7 0
0 17 17 17 0 0 18 7 7 7 7
0 0 7 7 0 0 18 17 7 7 17
7 7 11 7 7 8 0 17 17 17 0
0 17 7 7 17 7 7 0 13 7 0
0 17 17 17 0 0 18 7 7 7 12
0 0 7 7 0 0 18 17 7 7 17
7 7 7 7 7 8 0 17 17 17 0
0 17 12 7 17 7 7 0 7 11 0
0 17 17 17 0 0 18 10 7 7 7
0 0 7 7 0 0 18 17 7 7 17
13 7 7 7 7 8 0 17 17 17 0
0 17 7 7 17 7 7 0 7 7 0
0 17 17 17 0 0 18 7 7 7 7
0 0 7 7 0 0 18 17 7 14 17
7 7 11 7 7 8 0 17 17 17 0
0 17 7 7 17 0 0 0 0 0 0
0 17 17 17 0 0 0 0 0 0 0
0 0 0 0 0 0 0 0 0 0 0
0 0 0 0 0 0 0 0 0 0 0
0 0 0 0 0 0 0 0 0 0 0
0 0 0 0 0 0 0 0 0 0 0
0 0 0 0 0 0 0 0 0 0 0
0 0 0 0 0 0 0 0 0 0 0
0 0 0 0 0 0 0 0 0 0 0
0 0 0 0 0 0 0 0 0 0 0
0 0 0 0 0 0 0 0 0 0 0
0 0 0 0 0 0 0 0 0 0 0
0 0 0 0 0 0 0 0 0 0 0
0 0 0 0 0 0 0 0 0 0 0
0 0 0 0 0 0 0 0 0 0 0
0 0 0 0 0 0 0 0 0 0 0
0 0 0 0 0 0 0 0 0 0 0
0 0 0 0 0 0 0 0 0 0 0
0 0 0 0 0 0 0 0 0 0 0
0 0 0 0 0 0 0 0 0 0 0
0 0 0 0 0 0 0 0 0 0 0
0 0 0 0 0 0 0 0 0 0 0
0 0 0 0 0 0 0 0 0 0 0
0 0 0 0 0 0 0 0 0 0 0
0 0 0 0 0 0 0 0 0 0 0
0 0 0 0 0 0 0 0 0 0 0
0 0 0 0 0 0 0 0 0 0 0
0 0 0 0 0 0 0 0 0 0 0
0 0 0 0 0 0 0 0 0 0 0
0 0 0 0 0 0 0 0 0 0 0
0 0 0 0 0 0 0 0 0 0 0
0 0 0 0 0 0 0 0 0 0 0
0 0 0 0 0 0 0 0 0 0 0
0 0 0 0 0 0 0 0 0 0 0
0 0 0 0 0 0 0 0 0 0 0
0 0 0 0 0 0 0 0 0 0 0
0 0 0 0 0 0 0 0 0 0 0
0 0 0 0 0 0 0 0 0 0 0
0 0 0 0 0 0 0 0 0 0 0
0 0 0 0 0 0 0 0 0 0 0
0 0 0 0 0 0 0 0 0 0 0
0 0 0 0 0 0 0 0 0 0 0
0 0 0 0 0 0 0 0 0 0 0
0 0 0 0 0 0 0 0 0 0 0