MODE 2
SIZE 11/70
LIMIT 0/24
COLOR LIMIT 4
STARS 1000/3200/6300
POWERUPS 1/0/0/1
7 7 7 7 7 0 7 7 7 7 7
5 5 7 7 7 7 7 7 2 2 0
5 15 5 7 7 18 7 7 2 12 2
5 5 0 0 18 18 0 0 2 2 0
0 0 0 0 0 18 0 0 0 0 0
7 7 7 7 7 7 7 7 7 7 7
0 2 2 0 0 18 0 0 1 1 0
2 12 2 0 18 18 0 1 11 1 0
0 2 2 0 0 18 0 0 1 1 0
7 7 7 7 7 7 7 7 7 7 7
0 1 1 7 7 7 7 7 5 5 0
1 11 1 0 7 7 0 5 15 5 0
0 1 1 0 0 18 0 0 5 5 0
0 0 0 0 18 18 0 0 0 0 0
0 0 0 0 0 18 0 0 0 0 0
7 7 7 7 7 7 7 7 7 7 7
17 7 7 7 7 7 7 7 7 7 17
17 0 0 0 0 0 0 0 0 17 0
0 17 12 0 0 0 0 0 11 17 0
0 17 0 0 0 0 0 0 17 0 0
0 0 17 0 0 0 0 0 17 0 0
0 0 17 18 18 18 18 17 0 0 0
0 0 0 0 0 0 0 0 0 0 0
0 0 0 0 0 0 0 0 0 0 0
0 0 0 0 0 0 0 0 0 0 0
0 0 0 0 0 0 0 0 0 0 0
0 0 0 0 0 0 0 0 0 0 0
0 0 0 0 0 0 0 0 0 0 0
0 0 0 0 0 0 0 0 0 0 0
0 0 0 0 0 0 0 0 0 0 0
0 0 0 0 0 0 0 0 0 0 0
0 0 0 0 0 0 0 0 0 0 0
0 0 0 0 0 0 0 0 0 0 0
0 0 0 0 0 0 0 0 0 0 0
0 0 0 0 0 0 0 0 0 0 0
0 0 0 0 0 0 0 0 0 0 0
0 0 0 0 0 0 0 0 0 0 0
0 0 0 0 0 0 0 0 0 0 0
0 0 0 0 0 0 0 0 0 0 0
0 0 0 0 0 0 0 0 0 0 0
0 0 0 0 0 0 0 0 0 0 0
0 0 0 0 0 0 0 0 0 0 0
0 0 0 0 0 0 0 0 0 0 0
0 0 0 0 0 0 0 0 0 0 0
0 0 0 0 0 0 0 0 0 0 0
0 0 0 0 0 0 0 0 0 0 0
0 0 0 0 0 0 0 0 0 0 0
0 0 0 0 0 0 0 0 0 0 0
0 0 0 0 0 0 0 0 0 0 0
0 0 0 0 0 0 0 0 0 0 0
0 0 0 0 0 0 0 0 0 0 0
0 0 0 0 0 0 0 0 0 0 0
0 0 0 0 0 0 0 0 0 0 0
0 0 0 0 0 0 0 0 0 0 0
0 0 0 0 0 0 0 0 0 0 0
0 0 0 0 0 0 0 0 0 0 0
0 0 0 0 0 0 0 0 0 0 0
0 0 0 0 0 0 0 0 0 0 0
0 0 0 0 0 0 0 0 0 0 0
0 0 0 0 0 0 0 0 0 0 0
0 0 0 0 0 0 0 0 0 0 0
0 0 0 0 0 0 0 0 0 0 0
0 0 0 0 0 0 0 0 0 0 0
0 0 0 0 0 0 0 0 0 0 0
0 0 0 0 0 0 0 0 0 0 0
0 0 0 0 0 0 0 0 0 0 0
0 0 0 0 0 0 0 0 0 0 0
0 0 0 0 0 0 0 0 0 0 0
0 0 0 0 0 0 0 0 0 0 0
0 0 0 0 0 0 0 0 0 0 0