MODE 2
SIZE 11/70
LIMIT 0/23
COLOR LIMIT 5
STARS 1000/5900/8600
POWERUPS 0/1/0/1
0 7 0 0 7 0 0 7 0 0 7
7 7 17 7 7 17 7 7 17 7 7
7 7 2 2 7 2 2 8 2 2 7
3 3 12 3 3 7 3 3 7 3 3
0 0 7 7 17 7 7 17 7 7 0
1 1 7 1 1 15 1 1 7 1 1
0 11 5 5 8 5 5 7 5 5 11
7 7 17 7 7 17 7 7 17 7 7
7 7 2 2 13 2 2 8 2 2 7
3 3 7 3 3 7 3 3 12 3 3
0 0 7 7 17 7 7 17 7 7 0
1 1 15 1 1 7 1 1 7 1 1
0 7 5 5 8 5 5 7 5 5 7
7 7 17 7 7 17 7 7 17 7 7
0 7 2 2 7 2 2 8 2 2 7
3 3 12 3 3 7 3 3 7 3 3
7 7 7 7 17 7 7 17 7 7 0
1 1 7 1 1 7 1 1 15 1 1
0 11 5 5 8 5 5 7 5 5 11
7 7 17 7 7 17 7 7 17 7 7
0 0 0 0 0 0 0 0 0 0 0
0 0 0 0 0 0 0 0 0 0 0
0 0 0 0 0 0 0 0 0 0 0
0 0 0 0 0 0 0 0 0 0 0
0 0 0 0 0 0 0 0 0 0 0
0 0 0 0 0 0 0 0 0 0 0
0 0 0 0 0 0 0 0 0 0 0
0 0 0 0 0 0 0 0 0 0 0
0 0 0 0 0 0 0 0 0 0 0
0 0 0 0 0 0 0 0 0 0 0
0 0 0 0 0 0 0 0 0 0 0
0 0 0 0 0 0 0 0 0 0 0
0 0 0 0 0 0 0 0 0 0 0
0 0 0 0 0 0 0 0 0 0 0
0 0 0 0 0 0 0 0 0 0 0
0 0 0 0 0 0 0 0 0 0 0
0 0 0 0 0 0 0 0 0 0 0
0 0 0 0 0 0 0 0 0 0 0
0 0 0 0 0 0 0 0 0 0 0
0 0 0 0 0 0 0 0 0 0 0
0 0 0 0 0 0 0 0 0 0 0
0 0 0 0 0 0 0 0 0 0 0
0 0 0 0 0 0 0 0 0 0 0
0 0 0 0 0 0 0 0 0 0 0
0 0 0 0 0 0 0 0 0 0 0
0 0 0 0 0 0 0 0 0 0 0
0 0 0 0 0 0 0 0 0 0 0
0 0 0 0 0 0 0 0 0 0 0
0 0 0 0 0 0 0 0 0 0 0
0 0 0 0 0 0 0 0 0 0 0
0 0 0 0 0 0 0 0 0 0 0
0 0 0 0 0 0 0 0 0 0 0
0 0 0 0 0 0 0 0 0 0 0
0 0 0 0 0 0 0 0 0 0 0
0 0 0 0 0 0 0 0 0 0 0
0 0 0 0 0 0 0 0 0 0 0
0 0 0 0 0 0 0 0 0 0 0
0 0 0 0 0 0 0 0 0 0 0
0 0 0 0 0 0 0 0 0 0 0
0 0 0 0 0 0 0 0 0 0 0
0 0 0 0 0 0 0 0 0 0 0
0 0 0 0 0 0 0 0 0 0 0
0 0 0 0 0 0 0 0 0 0 0
0 0 0 0 0 0 0 0 0 0 0
0 0 0 0 0 0 0 0 0 0 0
0 0 0 0 0 0 0 0 0 0 0
0 0 0 0 0 0 0 0 0 0 0
0 0 0 0 0 0 0 0 0 0 0
0 0 0 0 0 0 0 0 0 0 0
0 0 0 0 0 0 0 0 0 0 0