MODE 2
SIZE 11/70
LIMIT 0/25
COLOR LIMIT 4
STARS 900/2300/5400
POWERUPS 1/0/0/1
10 7 7 7 7 7 7 7 7 7 17
17 7 7 7 0 0 7 7 7 7 17
17 7 11 7 0 7 0 7 11 7 17
17 7 7 7 7 7 7 7 7 7 17
17 7 7 7 0 7 0 7 7 7 10
17 7 7 7 0 0 7 7 7 7 17
17 7 7 12 7 7 7 7 13 7 17
17 7 7 7 0 0 7 7 7 7 17
17 7 7 7 0 7 0 7 7 7 17
10 7 7 7 7 7 7 7 7 7 17
17 7 7 7 0 7 0 7 7 7 17
17 7 12 7 0 0 7 7 13 7 17
17 7 7 7 7 0 7 7 7 7 17
17 7 7 7 7 7 7 7 7 18 0
0 18 0 7 7 7 7 7 0 18 0
0 18 0 7 7 14 7 0 18 0 0
0 0 18 0 7 7 7 0 18 0 0
0 0 18 0 7 7 0 18 0 0 0
0 0 0 18 0 0 0 18 0 0 0
0 0 0 18 18 18 18 0 0 0 0
0 0 0 0 0 0 0 0 0 0 0
0 0 0 0 0 0 0 0 0 0 0
0 0 0 0 0 0 0 0 0 0 0
0 0 0 0 0 0 0 0 0 0 0
0 0 0 0 0 0 0 0 0 0 0
0 0 0 0 0 0 0 0 0 0 0
0 0 0 0 0 0 0 0 0 0 0
0 0 0 0 0 0 0 0 0 0 0
0 0 0 0 0 0 0 0 0 0 0
0 0 0 0 0 0 0 0 0 0 0
0 0 0 0 0 0 0 0 0 0 0
0 0 0 0 0 0 0 0 0 0 0
0 0 0 0 0 0 0 0 0 0 0
0 0 0 0 0 0 0 0 0 0 0
0 0 0 0 0 0 0 0 0 0 0
0 0 0 0 0 0 0 0 0 0 0
0 0 0 0 0 0 0 0 0 0 0
0 0 0 0 0 0 0 0 0 0 0
0 0 0 0 0 0 0 0 0 0 0
0 0 0 0 0 0 0 0 0 0 0
0 0 0 0 0 0 0 0 0 0 0
0 0 0 0 0 0 0 0 0 0 0
0 0 0 0 0 0 0 0 0 0 0
0 0 0 0 0 0 0 0 0 0 0
0 0 0 0 0 0 0 0 0 0 0
0 0 0 0 0 0 0 0 0 0 0
0 0 0 0 0 0 0 0 0 0 0
0 0 0 0 0 0 0 0 0 0 0
0 0 0 0 0 0 0 0 0 0 0
0 0 0 0 0 0 0 0 0 0 0
0 0 0 0 0 0 0 0 0 0 0
0 0 0 0 0 0 0 0 0 0 0
0 0 0 0 0 0 0 0 0 0 0
0 0 0 0 0 0 0 0 0 0 0
0 0 0 0 0 0 0 0 0 0 0
0 0 0 0 0 0 0 0 0 0 0
0 0 0 0 0 0 0 0 0 0 0
0 0 0 0 0 0 0 0 0 0 0
0 0 0 0 0 0 0 0 0 0 0
0 0 0 0 0 0 0 0 0 0 0
0 0 0 0 0 0 0 0 0 0 0
0 0 0 0 0 0 0 0 0 0 0
0 0 0 0 0 0 0 0 0 0 0
0 0 0 0 0 0 0 0 0 0 0
0 0 0 0 0 0 0 0 0 0 0
0 0 0 0 0 0 0 0 0 0 0
0 0 0 0 0 0 0 0 0 0 0
0 0 0 0 0 0 0 0 0 0 0
0 0 0 0 0 0 0 0 0 0 0
0 0 0 0 0 0 0 0 0 0 0