MODE 2
SIZE 11/70
LIMIT 0/26
COLOR LIMIT 4
STARS 1200/7000/13000
POWERUPS 1/1/0/1
1 1 1 1 7 7 7 7 7 7 7
1 11 1 1 7 7 0 0 0 0 0
1 1 1 1 18 7 7 0 0 0 0
0 0 0 7 8 7 7 1 1 1 1
0 0 0 0 7 18 7 1 1 12 1
0 0 0 7 7 18 7 1 1 1 1
2 2 2 2 7 18 7 0 0 0 0
2 2 12 2 18 7 0 0 0 0 0
2 2 2 2 18 7 0 0 0 0 0
0 0 7 7 8 7 7 2 2 2 2
0 0 0 7 7 18 7 2 11 2 2
0 0 0 7 7 18 7 2 2 2 2
5 5 5 5 7 7 18 0 0 0 0
5 5 15 5 7 18 0 0 0 0 0
5 5 5 5 7 18 0 0 0 0 0
0 0 7 7 18 7 7 5 5 5 5
0 0 0 7 7 18 7 5 13 5 5
0 0 0 7 7 18 7 5 5 5 5
3 3 3 3 7 7 8 7 7 0 0
3 3 13 3 7 18 7 7 0 0 0
3 3 3 3 7 18 7 7 0 0 0
0 0 7 7 18 7 7 3 3 3 3
0 0 0 7 7 18 7 3 15 3 3
0 0 0 7 7 18 7 3 3 3 3
0 0 0 0 0 0 0 0 0 0 0
0 0 0 0 0 0 0 0 0 0 0
0 0 0 0 0 0 0 0 0 0 0
0 0 0 0 0 0 0 0 0 0 0
0 0 0 0 0 0 0 0 0 0 0
0 0 0 0 0 0 0 0 0 0 0
0 0 0 0 0 0 0 0 0 0 0
0 0 0 0 0 0 0 0 0 0 0
0 0 0 0 0 0 0 0 0 0 0
0 0 0 0 0 0 0 0 0 0 0
0 0 0 0 0 0 0 0 0 0 0
0 0 0 0 0 0 0 0 0 0 0
0 0 0 0 0 0 0 0 0 0 0
0 0 0 0 0 0 0 0 0 0 0
0 0 0 0 0 0 0 0 0 0 0
0 0 0 0 0 0 0 0 0 0 0
0 0 0 0 0 0 0 0 0 0 0
0 0 0 0 0 0 0 0 0 0 0
0 0 0 0 0 0 0 0 0 0 0
0 0 0 0 0 0 0 0 0 0 0
0 0 0 0 0 0 0 0 0 0 0
0 0 0 0 0 0 0 0 0 0 0
0 0 0 0 0 0 0 0 0 0 0
0 0 0 0 0 0 0 0 0 0 0
0 0 0 0 0 0 0 0 0 0 0
0 0 0 0 0 0 0 0 0 0 0
0 0 0 0 0 0 0 0 0 0 0
0 0 0 0 0 0 0 0 0 0 0
0 0 0 0 0 0 0 0 0 0 0
0 0 0 0 0 0 0 0 0 0 0
0 0 0 0 0 0 0 0 0 0 0
0 0 0 0 0 0 0 0 0 0 0
0 0 0 0 0 0 0 0 0 0 0
0 0 0 0 0 0 0 0 0 0 0
0 0 0 0 0 0 0 0 0 0 0
0 0 0 0 0 0 0 0 0 0 0
0 0 0 0 0 0 0 0 0 0 0
0 0 0 0 0 0 0 0 0 0 0
0 0 0 0 0 0 0 0 0 0 0
0 0 0 0 0 0 0 0 0 0 0
0 0 0 0 0 0 0 0 0 0 0
0 0 0 0 0 0 0 0 0 0 0
0 0 0 0 0 0 0 0 0 0 0
0 0 0 0 0 0 0 0 0 0 0
0 0 0 0 0 0 0 0 0 0 0
0 0 0 0 0 0 0 0 0 0 0