MODE 2
SIZE 11/70
LIMIT 0/21
COLOR LIMIT 5
STARS 900/4200/6200
POWERUPS 1/0/0/1
0 7 7 0 7 7 7 0 7 7 0
7 8 7 0 7 7 0 7 11 7 0
0 7 7 0 7 10 7 0 7 7 0
7 7 7 0 7 7 0 7 7 7 0
0 7 7 0 7 12 7 0 7 7 0
7 15 7 0 7 7 0 7 8 7 0
0 7 7 0 7 7 7 0 7 7 0
7 7 7 0 7 7 0 7 7 7 0
0 7 7 0 7 10 7 0 7 7 0
7 8 7 0 7 7 0 7 7 7 0
0 7 7 0 7 7 7 0 7 7 0
7 7 7 0 7 7 0 7 7 7 0
0 0 7 11 7 0 7 7 7 0 0
0 0 7 7 0 0 7 7 0 0 0
0 0 7 7 7 10 7 7 7 0 0
0 0 12 7 0 0 7 7 0 0 0
0 0 7 7 7 17 7 8 7 0 0
0 0 7 7 0 0 7 7 0 0 0
0 0 7 7 7 10 7 7 7 0 0
0 0 7 7 0 0 7 7 0 0 0
0 0 7 8 7 17 7 7 7 0 0
0 0 0 0 0 0 0 0 0 0 0
0 0 0 0 0 0 0 0 0 0 0
0 0 0 0 0 0 0 0 0 0 0
0 0 0 0 0 0 0 0 0 0 0
0 0 0 0 0 0 0 0 0 0 0
0 0 0 0 0 0 0 0 0 0 0
0 0 0 0 0 0 0 0 0 0 0
0 0 0 0 0 0 0 0 0 0 0
0 0 0 0 0 0 0 0 0 0 0
0 0 0 0 0 0 0 0 0 0 0
0 0 0 0 0 0 0 0 0 0 0
0 0 0 0 0 0 0 0 0 0 0
0 0 0 0 0 0 0 0 0 0 0
0 0 0 0 0 0 0 0 0 0 0
0 0 0 0 0 0 0 0 0 0 0
0 0 0 0 0 0 0 0 0 0 0
0 0 0 0 0 0 0 0 0 0 0
0 0 0 0 0 0 0 0 0 0 0
0 0 0 0 0 0 0 0 0 0 0
0 0 0 0 0 0 0 0 0 0 0
0 0 0 0 0 0 0 0 0 0 0
0 0 0 0 0 0 0 0 0 0 0
0 0 0 0 0 0 0 0 0 0 0
0 0 0 0 0 0 0 0 0 0 0
0 0 0 0 0 0 0 0 0 0 0
0 0 0 0 0 0 0 0 0 0 0
0 0 0 0 0 0 0 0 0 0 0
0 0 0 0 0 0 0 0 0 0 0
0 0 0 0 0 0 0 0 0 0 0
0 0 0 0 0 0 0 0 0 0 0
0 0 0 0 0 0 0 0 0 0 0
0 0 0 0 0 0 0 0 0 0 0
0 0 0 0 0 0 0 0 0 0 0
0 0 0 0 0 0 0 0 0 0 0
0 0 0 0 0 0 0 0 0 0 0
0 0 0 0 0 0 0 0 0 0 0
0 0 0 0 0 0 0 0 0 0 0
0 0 0 0 0 0 0 0 0 0 0
0 0 0 0 0 0 0 0 0 0 0
0 0 0 0 0 0 0 0 0 0 0
0 0 0 0 0 0 0 0 0 0 0
0 0 0 0 0 0 0 0 0 0 0
0 0 0 0 0 0 0 0 0 0 0
0 0 0 0 0 0 0 0 0 0 0
0 0 0 0 0 0 0 0 0 0 0
0 0 0 0 0 0 0 0 0 0 0
0 0 0 0 0 0 0 0 0 0 0
0 0 0 0 0 0 0 0 0 0 0
0 0 0 0 0 0 0 0 0 0 0